1111111111111
10010000000C1
1000011110001
10010000000C1
1P0011CE00001
1111111111111
